### ### ##### ###
#   # # # # # # #
# # ### # # # ##
### # # # # #  ##
                 
### # # ### ###  
# # # # # # # #  
# # # # ##  #### 
###  #   ## #  # 
