####             
#  # ### ##### ##
#    # # # # # # 
# ## ### # # # ##
#  # # # # # # # 
#### # # # # # ##
                 
####             
#  # #  # ## ### 
#  # #  # #  # # 
#  # # ## ## ####
#  # # #  #  #  #
#### ###  ## #  #
