############
#o  .    g+#
##### ######
#..........#
#..........#
#..........#
#..........#
#..........#
#..........#
############
