###########
#.. ... ..#
### ### # #
    ...
#.# ### #.#
#.# .o. #.#
#.# ### #.#
    ...
# # ### ###
#.. ... .g#
###########
