##############
#...#...#....#
#.#.#.#.#..#.#
#o#.#.#.#..#.#
# #.#.#.#.+#.#
# #.#.#.#..#.#
#g#...#....#.#
##############
