######
#    #
# ## #
# ## #
# ## #
# o  #
######
