##########
#o.     ##
 ######  
      ####
#### ###..
   # #. #
##    #.##
   #  #..#
...#.....#
##########
