##########
#o.......#
#.......+#
#........#
#........#
#.......g#
##########
