######
#   .#
# ## #
# ## #
# ## #
# o  #
######
