############
#o  .     g#
##### ######
#..........#
#..........#
#..........#
#..........#
#..........#
#..........#
############
