#########
#.......#####
#.     .    #
#.g##  .   ##
#. ##  .  o#
#.......####
#########
