##########
#o.......#
#.       #
#.       #
#.       #
#.      g#
##########
