#########
#.......#####
#.     .    #
#. ##  .   ##
#. ##  .  o#
#.......####
#########
