##########
#o.......#
#........#
#........#
#........#
#.......g#
##########
