#### ####
#       #
# ## ## #
#       #
# ## ## #
#       #
# ## ## #
    o    
# ## ## #
#       #
#g      #
#### ####
