#########
#.......#####
#.     .    #
#.g##  .   ##
#. ##g .  o#
#.......####
#########
