#### ####
#.  .  .#
# ## ## #
# ..... #
# ## ## #
# ..... #
# ## ## #
    o    
# ## ## #
#. . . .#
#g  .   #
#### ####
